00000000000000000000
00000000000000000000
0P000000000000000000
00000000000000000000
00000000000000000000
00001111111111110000
00000000000000000000
00000000011100000000
00000000000000000000
00111100000000001100
00000000000000000000
00000011111111000000
00000000000000000000
00000000000000000G00
11111111111111111111