000000000000000000000000
00P000000000000000000000
000000000000000000000000
000000000000001111111000
000011110000000000000000
000000000000000000000000
000000000111110000000000
000000000000000000011000
011100000000000000000000
000000000000111000000000
000000000000000000000000
000001111000000000000000
000000000000000000000G00
111111111111111111111111